NO ./path_to_the_north_texture
SO ./path_to_the_south_texture
WE ./path_to_the_west_texture
EA ./path_to_the_east_texture

F 2,168,168
C 178,7,144

    11111111111111111111111111111
    1110000000001100000000000011111
    100011000001110000000000000011
    1000000000000000000000000111111
    	1000010000000000000000000000111
1111111000110000011100000000000011
100000000011000001110000011111111
100000111101111001100000010001
110000001111110000010100100001
110000001101000111000000100011
10000000000000001100000000001111
10000000000000001101010000000001
11000001110001011111011110111001
11110000000000000000010111100001
111111110000011111111111111111111
1111111100N0011111111111111111111
111111110000011111111111111111111
111111111111111111111111111111111
