NO ./path_to_the_north_texture
SO ./path_to_the_south_texture
WE ./path_to_the_west_texture
EA ./path_to_the_east_texture

F 2,168,168
C 178,789,144



1111111111111111
1100000000001001
1100000111100011
1000N00000000001
1111111111111111
1111111111111111
